################################
#..............................#
#..~~~~~.......................#
#..~~~~~.......................#
#..~~~~~.......................#
#..~~~~~..#############........#
#..~~~~~..#....................#
#..~~~~~..#....................#
#..~~~~~..#....................#
#.........#....................#
#.........#.................#..#
#.........#.................#..#
#.........#.....@...........#..#
#.........#.................#..#
#.........#.................#..#
#.........#...........~~~~~~#..#
#.........#...........~~~~~~#..#
#.........#...........~~~~~~#..#
#.............###############..#
#.....................~~~~~~...#
#.....................~~~~~~...#
#..............................#
#..............................#
################################
