####################
#..................#
#..................#
#.~~~~~............#
#.~~~~~...######...#
#.~~~~~...#........#
#.~~~~~...#........#
#.........#........#
#.........#........#
#.........#........#
#.........#........#
#.........#........#
#.........#........#
#..................#
#...######.........#
#..............@...#
#..................#
#..................#
#..................#
####################
