##########
#...#.o..#
#.O...o..#
#..##O#..#
#.O..o...#
#...@....#
#........#
##########
